****************
* **    * *   E*
**** *  * ** ***
*    *    ** * *
*    * *  **   *
*    *  * ***  *
*S   *  *      *
****************