****************
* **    * *  *E*
**** *  * ** ***
*    *    ** * *
**** * *  **   *
*    *  * ***  *
*S  **  *      *
****************