************************************************************
*S       ************ ***************** *********          *
*                       ***          **                *  E*
*****************  *********** *********************** *****
*******           ******** *         ******* ********  *****
**        **  ********           *********** ******        *
********                *****                        **    *
************************************************************